
NO  sample_640×426.xpm
WE sample_640×426.xpm 

EA sample_640×426.xpm
SO sample_640×426.xpm

F 1, 255,   20
C 5, 130,   50

   11111111111111111111111111   
 1101101N010011000000000111111 
 100000001 11000000000000011
 10000011 11000000000000001
11111111111111111111111111
